JLPT N3 07/2010:

---------------------------------
市民: しみん「THỊ DÂN」: Thị dân, dân thành phố
力を合わせて: Hợp tác, chung tay
規則: きそく 「QUY TẮC」 : Quy tắc
禁止: きんし: Cấm
止める: dừng lại (hoạt động của máy móc)
様々: さまざま: Khác nhau
結局: けっきょく「KẾT CỤC」: Kết cục, rốt cuộc là...
いく らでも: bất kì, bất cứ cái gì đó... 
最終的: さいしゅうてき: (TỐI CHUNG ĐÍCH): Mục đích cuối cùng thì... || Cuối cùng...
物差し: ものさし「VẬT SOA」: Thước đo, tiêu chuẩn...
重要: じゅうよう 「TRỌNG YẾU」: trọng yếu, quan trọng (Một cho một việc gì đó quan trọng mang tính khẩn cấp, Dùng cho nhân vật quan trọng nào đó)
下記: かき HẠ KÍ: điều viết dưới đây
目的: mục đích
文房具: ぶんぼうぐ: Văn phòng phẩm
新学期: しんがっき「TÂN HỌC KÌ」: Học kì mới
先日せんじつ: 「TIÊN NHẬT」: Vài ngày trước 
都合: つごう: 「ĐÔ HỢP」: thuận lợi, thuận tiện
ように頼むこと: yêu cầu....
切手: きって: 「THIẾT THỦ」:tem, tem hàng
開館: かいかん: 「KHAI QUÁN」: Sự mở cửa, khai trương quán.
記念: きねん: 「KÍ NIỆM」: Kỉ niệm
種類: しゅるい: 「CHỦNG LOẠI」: Loại, chủng loại
発売: はつばい: 「PHÁT MẠI」: Sự bán ra, phát hành.
使用する: しよう: Sử dụng (SỬ DỤNG)
募集: ぼしゅう: 「MỘ TẬP」: tuyển dụng, chiêu mộ
平和: へいわ:(BÌNH HÒA): Hòa bình
環境: かんきょう: 「HOÀN CẢNH」: Môi trường
応募: おうぼ: 「ỨNG MỘ」: ứng tuyển, đăng kí
指定: してい: 「CHỈ ĐỊNH」: chỉ định
近所: きんじょ:「CẬN SỞ]: hàng xóm
閉店: へいてん: 「BẾ ĐIẾM」: đóng cưa hàng
愛着: あいちゃく: 「ÁI TRỨ」: Quyết luyến thứ gì đó gắn bó với mình từ nhỏ
重なる: かさなる: chồng chất, trùng với.
出し合う: だしあう: 「XUẤT HỢP」: Đóng góp, cùng chia sẻ (tiền bạc)
担任:「ĐAM NHÂM」: たんにん... : giáo viên chủ nhiệm
話し合う: はなしあう: bàn bạc, trao đôi
お小遣い: おこづかい: 「TIỂU KHIỂN」: tiền tiêu vặt.
できるだけ: Cố gắng hết sức có thể trong khả năng của mình.
どきどき: hồi hộp
伝える: つたえる: truyền tải
新聞紙: しんぶんし: giấy báo
再使用: さいしよう: tái sử dụng
洗: あら.う: rửa
しっかり: chắc chắn, ổn định, nghiêm túc
厚: あつ.い (HẬU): chiều dày
以前: いぜん: trước đây
丈夫: じょうぶ: bền chắc
比較: ひかく: Sự so sánh
影響: えいきょう: sự ảnh hưởng
与える: あたえる: gây ra,...
長い間:ながいあいだ:  trong thời gian dài
主人: しゅじん: ông chủ
収入: しゅうにゅう: 「THU NHẬP」: Thu nhập shuuniuu
やってよかった: Rất vui vì làm điều gì đó...
あつかう: 扱う: TRÁP: sử dụng làm.. (vật liệu)
健康: けんこう: sức khỏe
夫婦: ふうふ: vợ chồng
知り合い: Người quen, quen biết 
手伝い: てつだい: giúp đỡ, sự hỗ trợ
熱心: ねっしん: nhiệt tình
研究: けんきゅう: 「NGHIÊN CỨU」: nghiên cứu
消える: きえる「TIÊU」: tan biến
その横で: bên cạnh đó
経験: けいけん: 「KINH NGHIỆM」: kinh nghiệm
経営する: けいえい: 「KINH DOANH」: kinh doanh
苦労: くろう: 「KHỔ LAO」: cực khổ
選択: せんたく: TUYỂN TRẠCH: sự lựa chọn
人生: じんせい: đời người, bản mệnh.
昼食: ちゅうしょく: bữa trưa
葉書: はがき:[DIỆP THƯ]:  bưu thiếp
持参: じさん: TRÌ THAM: mang theo
集合場所: しゅうごう ばしょ: 「TẬP HỢP TRÀNG SỞ」: Nơi gặp gỡ, nơi hội họp.
定員: ていいん「ĐỊNH VIÊN」: sức chứa
住所: じゅうしょ: 「TRỤ SỞ : Chỗ ở
氏名:しめい: 「THỊ DANH」: họ và tên
消印: けしいん: Việc đóng dấu của bưu điện. đóng lên tem để tránh tái sử dụng tem
有効: ゆうこう: 「HỮU HIỆU: hiệu quả, có hiệu quả
当日: とうじつ: ngày hôm đó, ngày được nhắc tới
締め切り: しめきり: 「ĐẾ THIẾT」: hạn chót
に限り: にかぎる: Chỉ khi...